Legend=█ OX
██████████████████████
██████████████████████
██████████████████████
███     █           ██
███ ███ █ ███████ █ ██
███ █   █ █       █ ██
███ █ ███ █ ███████ ██
███ █ █   █ █   █   X█
███ █ █ ███ ███ █ ████
███ █   █   █   █ █ ██
█████████ ███ ███ █ ██
███   █   █ █     █ ██
███ █ █ ███ █ █████ ██
███ █   █   █ █     ██
███ █████ ███ █ ███ ██
███   █       █   █ ██
███ █ █████ ███████ ██
███ █     █         ██
███ █████ █████████ ██
███     █ █         ██
█████████O████████████
██████████████████████
