Legned=█ OX
████████████
██O█████████
██   █   ███
████ █ █ ███
██ █   █ ███
█X █████ ███
██     █ ███
██ █ ███ ███
██ █     ███
████████████
████████████
████████████