MMMMMMMMMMMM
MMOMMMMMMMMM
MM   M   MMM
MMMM M M MMM
MM M   M MMM
MQ MMMMM MMM
MM     M MMM
MM M MMM MMM
MM M     MMM
MMMMMMMMMMMM
MMMMMMMMMMMM
MMMMMMMMMMMM