Legned=█ OX
██████████████████████
██████O███X███████████
██   █     █       ███
████ █████ █ ███ █ ███
██   █ █   █   █ █ ███
██ █ █ █ ███████ █ ███
██ █   █ █     █ █ ███
██ ███ █ ███ █ █ █ ███
██ █ █ █     █ █ █ ███
██ █ █ ███████ █ █ ███
██ █   █     █   █ ███
██ █ ███████ █████ ███
██ █   █       █   ███
██ ███ █ █████ █ █████
██   █   █     █   ███
██ █ █████████████ ███
██ █ █       █     ███
██ █ █ █████ █ ███████
██ █       █       ███
██████████████████████
██████████████████████
██████████████████████
