Legned=█ OX
██████████████████████
████O█████X███████████
██ █     █         ███
██ █████ ███ █████ ███
██     █     █     ███
██ ███████████ ███████
██           █     ███
██████ ███████████ ███
██     █       █   ███
██ █████ ███ ███ █████
██ █     █ █   █   ███
██ █ █████ ███ ███ ███
██ █ █   █   █     ███
██ █ █ █ ███ █████████
██ █   █     █     ███
██ █████████ █ ███████
██   █     █ █     ███
██ ███ █ ███ █████ ███
██     █           ███
██████████████████████
██████████████████████
██████████████████████
