MMMMMMMMMMMMMMMMM
MMMMMMMMOMMMMMMMM
MM       M     MM
MM MMMMMMM MMM MM
MM M       M M MM
MM MMMMM MMM M MM
MM     M M     MM
MMMMMM M M MMMMMM
MM   M M M M   MM
MM MMM M MMM M MM
MM     M     M MM
MM MMMMMMMMMMM MM
MM         M   MM
MMMMMMMMMM M M MM
MM           M MM
MMMMMMMMMQMMMMMMM
MMMMMMMMMMMMMMMMM
