Legned=█ OX
█████████████████
████████O████████
██       █     ██
██ ███████ ███ ██
██ █       █ █ ██
██ █████ ███ █ ██
██     █ █     ██
██████ █ █ ██████
██   █ █ █ █   ██
██ ███ █ ███ █ ██
██     █     █ ██
██ ███████████ ██
██         █   ██
██████████ █ █ ██
██           █ ██
█████████X███████
█████████████████
