Legend=█ OX
█████████████████
██████O██████████
██ █   █   █   ██
██ █ ███ █ █ █ ██
██ █     █ █ █ ██
██ ███████ █ █ ██
██ █     █   █ ██
██ █ █ ███████ ██
██ █ █       █ ██
██ █ ███████ █ ██
██   █     █ █ ██
██ ███ ███ █ █ ██
██     █ █ █   ██
████████ █ ██████
██             ██
████X████████████
█████████████████
