Legend=█ OX
█████████████████
█████████████████
█████████████████
██             ██
██ ███████ ███ X█
██ █     █   █ ██
████ ███ █████ ██
██   █ █   █   ██
██ ███ ███ █ █ ██
█O █     █   █ ██
████ █ ███████ ██
██   █   █     ██
██ █████ █ ██████
██     █       ██
█████████████████
█████████████████
█████████████████
