Legend=█ OX
█████████████████
█████████████████
█████████████████
█O   █ █     █ ██
████ █ █ █ █ █ ██
█X   █   █ █   ██
██ █████ █ ██████
██     █ █ █   ██
██████ █ █ █ █ ██
██   █ █ █   █ ██
██ █ █ █ █████ ██
██ █ █ █   █   ██
██ ███ █████ █ ██
██           █ ██
█████████████████
█████████████████
█████████████████
