Legend=█ OX
█████████████████
██████████████X██
██     █       ██
██ ███ █ ███ ████
██   █ █   █   ██
████ █ ███████ ██
██   █       █ ██
██ █████████ █ ██
██         █   ██
██ ███████ ██████
██ █     █     ██
██ █████ █████ ██
██ █   █     █ ██
██ █ █ ███ █ █ ██
██   █     █ █ O█
█████████████████
█████████████████
